11111111111111111
10000000000000001
10000000000000001
10000000000000001
10000000000000001
10000000000000001
11111111111110001
10000000000000001
10000000000000001
10011111100111101
11010000000000001
10010000000100001
11111111111111111
